111111111111111
001000001000101
111111101110101
100010101000000
111010101111111
101010101000101
101010101110101
101010001000001
101011101111101
001010000010001
111011111011101
000000000010101
111111111110101
001010000000100
111011111110111
