111111111111111
101010001000000
101011101111111
000010000010101
111111111010101
000010000010101
111111111010101
101000100010101
101110111010101
100010101000100
111010101110111
000000001010101
111111111010101
101010101000000
101010101111111
