111111111111111
001000001000000
111111101111111
000010100010001
111110111011101
000010001010101
111111101010101
100000100010101
111110111010101
000000000010001
111111111111101
001010101000101
111010101110101
000010100000101
111110111110101
