111111111111111
101010001000001
101011101111101
000000001010000
111111111011111
101010100010000
101010111011111
100000100010001
111110111011101
100010100010100
111010111010111
101010100010100
101010111010111
000010101000101
111110101110101
