111111111111111
000000001000001
111111111111101
000010100010001
111110111011101
100000101000001
111110101111101
000000001000000
111111111111111
000010101000100
111110101110111
100000001000100
111111101110111
000000101000001
111111101111101
