111111111111111
101010000010001
101011111011101
001000000000000
111111111111111
101010001010101
101011101010101
000010100000100
111110111110111
101000001000100
101111101110111
100000000010000
111111111011111
101010100010001
101010111011101
