111111111111111
001000101010100
111110101010111
000010101010001
111110101011101
001000101010100
111110101010111
000000000000001
111111111111111
100000001000100
111111101110111
100010000000100
111011111110111
101010001000100
101011101110111
