111111111111111
101010101010101
101010101010101
101000101000000
101110101111111
100010001000000
111011101111111
001010001000101
111011101110101
100000100010101
111110111010101
100000001010100
111111101010111
101010001000001
101011101111101
