111111111111111
001000101000100
111110101110111
100010000010001
111011111011101
100010101000000
111010101111111
001010000010000
111011111011111
001000001010001
111111101011101
000010101010100
111110101010111
001000101010001
111110101011101
