111111111111111
100010100000100
111010111110111
101010000010101
101011111010101
000010001010101
111111101010101
001010000000100
111011111110111
000000101000101
111111101110101
000000101000101
111111101110101
100000101010101
111110101010101
