111111111111111
000000100010001
111111111011101
001010000010001
111011111011101
000000001010101
111111111010101
000010101000101
111110101110101
000000001010001
111111111011101
001000101000001
111110101111101
100010100000001
111010111111101
