111111111111111
000000000000101
111111111111101
100000001010100
111111101010111
001010100010100
111010111010111
001010001000101
111011101110101
000000101000101
111111101110101
001000100010000
111110111011111
100000000000000
111111111111111
