111111111111111
000000001000100
111111111110111
100010100000000
111010111111111
100000100000100
111110111110111
100010100010100
111010111010111
101000100000101
101110111110101
100010000000101
111011111110101
100000100000001
111110111111101
