111111111111111
101010100000101
101010111110101
000010001010000
111111101011111
101000001000100
101111101110111
000010101000000
111110101111111
101010000000000
101011111111111
100010000000000
111011111111111
101000000000100
101111111110111
